10



o o o o o
o o o o o
o o o o o
o o c o o



10

o o o o o
o o o o o
o o o o o
o o o o o

10


o o o o o
o o o o o
o o o o o
o o o o x

x x x x x
x o o o x
x o o o x
x x x x x

x x x x x
x o o o x
x o o o x
x x x x x

x x x x x
x o o o x
x o o o x
x x x x x

x x x x x
x o o o x
x o o o x
x x x x x

10


o o j o o
o o o o o
o o o o o
o o o o x

10

o o o o o
o o o o o
o o o o o
o o o o x

10

o o o o o
o o o o o
o o o o o
o o o o x

10

o o o o o
o o o o o
o o o o o
o o o o x

10

o o o o o
o o o o o
o o o o o
o o o o x

10

o o o o o
o o o o o
o o o o o
o o o o x

10

o o o o o
o o o o o
o o o o o
o o o o x

10

x x x x x
x o o o x
x o o o x
x x x x x

x x x x x
x o o o x
x o o o x
x x x x x

x x x x x
x o o o x
x o o o x
x x x x x

x x x x x
x o o o x
x o o o x
x x x x x

10

o o o o o
o o o o o
o o o o o
o o o o x

10

o o o o o
o o o o o
o o o o o
o o o o x

10

o o o o o
o o o o o
o o o o o
o o o o x

10

o o o o o
o o o o o
o o o o o
o o o o x

10

o o o o o
o o o o o
o o o o o
o o o o x

10

o o o o o
o o o o o
o o o o o
o o o o x

10


o j2 o o o
o o o o o
o o o o o
o o o o o

10


o j2 o o o
o o o o o
o o o o o
o o o o o


10


o j2 o o o
o o o o o
o o o o o
o o o o o


10


o j2 o o o
o o o o o
o o o o o
o o o o o


10


o j2 o o o
o o o o o
o o x o o
o o o o o


10


o j2 o o o
o o o o o
o o o o o
o o o o o


10


o j2 o o o
o o o o o
o o o o o
o o o o o


10


o j2 o o o
o o o o o
o o o o o
o o o o o




100